capacity 10
iterations 100000
schools 0 1
0 0 0 2 1 1 1 1
0 0 1 0 1 0 0 2
nodes 8
0 666 570 1869 1370 957 710 776 
604 0 711 1432 1706 945 1242 248 
555 805 0 2108 1145 1470 870 928 
1847 1446 2098 0 3075 1128 2246 1359 
1376 1787 1148 3032 0 2150 1026 1910 
943 891 1471 1147 2144 0 1315 927 
661 1267 856 2227 1082 1298 0 1353 
773 219 912 1343 1907 973 1389 0 
(13.384116, 52.533558)
(13.428726, 52.519355)
(13.415932, 52.564154)
(13.485719, 52.434323)
(13.362764, 52.622898)
(13.369894, 52.474778)
(13.337637, 52.554196)
(13.436690, 52.510699)