capacity 10
schools 0 1
nodes 10
0 666 1845 797 835 1419 1129 1133 584 1493 
604 0 1336 1178 782 1600 1279 587 551 1169 
1815 1368 0 2387 1933 1559 2587 1334 1289 678 
804 1256 2405 0 1100 1635 853 1640 1137 2030 
863 864 1933 1122 0 2195 1001 894 1207 1945 
1404 1508 1527 1754 2092 0 2365 2010 1077 1152 
1295 1547 2753 1037 1116 2520 0 1887 1729 2590 
1111 570 1369 1622 899 2138 1691 0 1097 1422 
584 545 1340 1183 1172 1130 1598 1046 0 965 
1473 1145 697 2045 1927 1117 2407 1448 947 0 
(13.384116, 52.533558)
(13.428726, 52.519355)
(13.493185, 52.436485)
(13.343266, 52.568130)
(13.457374, 52.563931)
(13.311440, 52.455303)
(13.403404, 52.608748)
(13.488136, 52.509866)
(13.385349, 52.501163)
(13.431997, 52.444218)