capacity 10
schools 0 1
6 5 8 3 3 4
5 6 1 4 3 2
nodes 8
0 666 1012 868 888 1339 1683 763 
604 0 648 981 1269 1527 1246 636 
891 593 0 1005 1446 2068 1407 1181 
803 942 1006 0 868 2100 2058 1413 
889 1341 1549 856 0 1628 2305 1393 
1325 1483 2068 2122 1743 0 1319 1038 
1660 1260 1469 2181 2323 1328 0 1082 
775 600 1185 1501 1438 1063 1115 0 
(13.384116, 52.533558)
(13.428726, 52.519355)
(13.481007, 52.530827)
(13.430105, 52.584444)
(13.343115, 52.577449)
(13.314377, 52.460986)
(13.474637, 52.438820)
(13.391452, 52.490840)