capacity 10
iterations 100 000 000
schools 0 1
0 0 0 2 2 3 3 1 2 1
0 0 4 2 2 2 1 1 3 1
nodes 10
0 666 1425 1767 782 652 1109 1260 743 1717 
604 0 1668 1357 238 728 1097 1236 1124 1179 
1431 1732 0 2958 1868 1149 2330 1175 896 2665 
1749 1371 2979 0 1334 2039 1017 2337 2268 677 
727 177 1845 1250 0 905 1079 1413 1250 1102 
644 733 1229 1959 869 0 1625 796 841 1666 
1104 1052 2360 1018 1095 1664 0 2191 1595 1299 
1252 1307 1197 2369 1443 767 2224 0 1205 1805 
722 1174 877 2222 1312 817 1547 1176 0 2150 
1621 1081 2591 761 1105 1651 1273 1753 2080 0 
(13.384116, 52.533558)
(13.428726, 52.519355)
(13.363846, 52.618857)
(13.466943, 52.436766)
(13.432102, 52.510943)
(13.425510, 52.561191)
(13.370746, 52.462456)
(13.480468, 52.591408)
(13.346720, 52.566513)
(13.517071, 52.462296)