capacity 10
iterations 2000000
schools 0 1
0 0 0 3 3 3 2 3
0 0 4 3 3 1 2 3
nodes 8
0 666 1109 865 1685 1425 913 600 
604 0 1097 855 1175 1668 1293 145 
1104 1052 0 1791 950 2360 1738 1060 
852 934 1826 0 1979 1111 1127 904 
1654 1189 923 1985 0 2797 2316 1298 
1431 1732 2330 1089 2777 0 794 1691 
851 1303 1676 1039 2283 837 0 1237 
612 161 1097 906 1249 1718 1302 0 
(13.384116, 52.533558)
(13.428726, 52.519355)
(13.370746, 52.462456)
(13.445470, 52.574374)
(13.483652, 52.445276)
(13.363846, 52.618857)
(13.339299, 52.574921)
(13.420079, 52.519863)